32	25																														
9	9	9	9	9	9	9	9	9	9	9	9	9	9	9	9	9	9	9	9	9	9	9	9	9	9	9	9	9	9	9	9
9	0	0	0	0	0	0	0	0	0	0	0	0	0	0	0	0	0	0	0	0	0	0	0	0	0	0	0	0	0	0	9
9	0	0	0	0	0	0	0	0	0	0	0	0	0	0	0	0	0	0	0	0	0	0	2	2	2	2	2	2	0	0	9
9	0	0	0	0	0	0	0	0	0	0	0	0	0	0	0	0	0	0	0	0	0	0	0	0	0	4	0	2	0	0	9
9	0	0	0	0	0	0	3	4	0	0	0	0	0	0	0	0	3	0	0	0	0	0	0	0	0	0	5	3	0	0	9
9	0	0	0	0	0	0	3	0	0	0	0	0	3	3	3	3	3	0	0	0	0	3	3	2	3	3	3	3	0	0	9
9	0	0	0	0	0	5	3	0	0	0	0	0	3	5	0	0	2	0	0	0	0	0	0	0	0	0	0	3	5	0	9
9	0	0	0	0	0	0	2	0	0	0	0	0	3	0	6	0	3	0	0	0	0	0	0	0	0	0	0	2	0	4	9
9	0	0	0	0	0	0	3	0	0	0	0	0	3	0	0	0	3	0	0	0	0	0	0	0	0	0	0	2	0	0	9
9	0	0	0	0	0	0	3	0	0	0	0	0	3	5	0	0	3	0	0	0	0	0	0	0	0	0	0	2	0	0	9
9	0	0	0	0	0	0	3	0	5	0	0	0	2	3	2	3	3	0	0	0	0	0	0	0	0	0	0	3	3	3	9
9	0	0	0	0	0	0	0	0	0	0	0	3	0	0	0	0	0	0	0	0	0	0	0	0	0	0	0	0	0	0	9
9	0	0	0	0	0	0	0	0	0	0	0	0	0	0	0	0	0	0	0	0	5	0	0	0	0	0	0	0	0	0	9
9	0	0	0	3	3	3	2	3	0	0	0	0	0	0	0	0	0	0	0	0	0	0	0	0	0	0	0	2	0	0	9
9	0	0	0	0	0	0	0	0	0	0	0	0	0	0	0	0	0	0	0	0	0	0	0	0	0	0	0	2	0	0	9
9	0	0	0	0	0	0	0	0	0	0	0	0	3	3	3	3	3	0	0	0	0	0	0	0	0	0	0	3	0	0	9
9	0	0	0	0	0	0	0	0	0	0	0	0	3	0	0	0	3	0	0	0	0	0	0	0	0	0	0	3	0	0	9
9	0	0	0	0	3	0	0	0	0	0	0	0	2	0	0	5	2	0	0	0	5	0	0	0	3	3	3	3	0	0	9
9	0	0	0	0	3	5	0	2	3	3	3	0	3	0	6	0	3	0	0	0	0	0	0	0	3	0	0	0	0	0	9
9	0	0	0	0	3	0	0	3	0	0	0	0	3	0	0	5	3	0	0	0	0	0	0	0	0	0	0	0	0	0	9
9	0	0	0	0	0	3	3	3	0	0	0	0	3	3	2	3	3	0	0	0	0	0	0	0	0	0	0	0	0	0	9
9	0	0	0	0	0	0	4	0	0	0	0	0	0	0	0	0	0	0	0	0	0	0	0	0	0	0	0	0	0	0	9
9	9	9	9	9	9	9	9	9	9	9	9	9	9	9	9	9	9	9	9	9	9	9	9	9	9	9	9	9	9	9	9
9	9	9	9	9	9	9	9	9	9	9	9	9	9	9	9	9	9	9	9	9	9	9	9	9	9	9	9	9	9	9	9
9	9	9	9	9	9	9	9	9	9	9	9	9	9	9	9	9	9	9	9	9	9	9	9	9	9	9	9	9	9	9	9
